4
1 2
40444444444444444444
43000400000004000004
41000400004444004004
42444000000000004004
40000000400044444444
40004444400000000004
40004000444000400004
40004000404000400444
40244000400000400004
40000000400044444444
40000044400000000004
40000043400444440004
40244440400400000044
40000040400400000004
40000000444400044004
44440000400000040004
43040000444444440004
40000044402000000044
40000000400040000034
44444444444444444444
