0
ÿ ÿ
44444444444444444444
4ÿÿÿÿ4ÿÿÿÿÿÿÿÿÿÿÿÿÿ4
4ÿÿÿÿ4ÿÿÿÿÿÿÿÿÿÿ4444
4ÿ444ÿÿÿÿÿÿÿÿÿÿÿ4ÿÿ4
4ÿÿÿÿÿÿÿ4ÿÿ444444ÿÿ4
4ÿÿÿ44444ÿÿÿÿÿ4ÿÿÿÿ4
4ÿÿÿ4ÿÿÿ444ÿÿÿÿÿÿÿÿ4
4ÿÿÿ4ÿÿÿ4ÿ4ÿÿÿ4ÿÿ444
4ÿÿ44ÿÿÿ4ÿÿÿÿÿ4ÿÿÿÿ4
4ÿÿÿÿÿÿÿ4ÿÿÿ4444ÿ444
4ÿÿÿÿÿ444ÿÿÿÿÿÿÿÿÿÿ4
4ÿÿÿÿÿ4ÿ4ÿÿ44444ÿÿÿ4
4ÿÿ4444ÿÿÿÿ4ÿÿÿÿÿÿ44
4ÿÿÿÿÿ4ÿÿÿÿ4ÿÿÿÿÿÿÿ4
4ÿÿÿÿÿÿÿ4ÿ44ÿÿÿ44ÿÿ4
4444ÿÿÿÿ4ÿÿÿÿÿÿ4ÿÿÿ4
4ÿÿ4ÿÿÿÿ44444444ÿÿÿ4
4ÿÿÿÿÿ444ÿÿÿÿÿÿÿÿÿ44
4ÿÿÿÿÿÿÿ4ÿÿÿÿÿÿÿÿÿÿ4
44444444444444444444
