1
2 1
44444444400000000000
40100000400000000000
40000000400000000000
40000000400000000000
40000000400000000000
40230000400000000000
44444444400000000000
00000000000000000000
00000000000000000000
00000000000000000000
00000000000000000000
00000000000000000000
00000000000000000000
00000000000000000000
00000000000000000000
00000000000000000000
00000000000000000000
00000000000000000000
00000000000000000000
00000000000000000000
