7
1 1
04444444444444444400
41040000040000000340
40200000040044444440
40340000000040043004
04440020004040000004
04000004002040004404
40000444000040000004
40000034444440000004
40000400000200040004
40000400044000040004
40200400000444400044
40040400004300000400
40044400000400000044
40000444444400000404
40000000004000000004
04004000004004440204
43000444002004300004
04000004400004000040
00444444044444444400
00000000000000000000
