5
B B
04444444444444444444
40000000000000430004
40024000040000444004
40000000040000000004
44444004444444444444
40000004020000000034
40200444000004000044
40000004444444000004
44440000000000000004
43040004000444044444
40040004000000000004
40040304000044400004
40044444440040000004
40002000000040204444
40004000000040000004
40044004000040000004
40040004444444000004
40040004000000004004
40043004000000004014
44444444444444444444
