;
8 9
04444444444444444444
43000000044000004034
40042440000004000004
40043000400044400004
44004004000440442404
43440204044300000004
40000200400400000004
40044400000040044424
40000040004004000004
44400040123444000044
44000042400004000044
40040043040004444004
40400004400040000244
40204000400000040004
40044044034004004004
40040000000440000004
40040004400020000434
40004000400204400044
43400000044000340004
44444444444444444444
