7
1 2
44444444444444444444
43000400000004000004
41000400204444004004
42444000200000004004
40000000400044444444
40004444400000430004
40004000444000000004
40004000434000400444
40044000400000400004
40000000400044440444
40200044400000000004
40000043400444440004
40244440400400002044
40000040400400000004
40000000404400044004
44440000403000040004
43040000444444440004
40000044402000000044
40000000400040000034
44444444444444444444
